.;.;1;.;.;1d;.;.;1l;.;.;.
.;.;.;2;.;.;.;.;2;.;.;.
.;.;.;.;.;3;.;.;.;.;.;.
.;1;.;.;1;.;.;1;.;.;1;.
.;.;.;.;.;.;.;.;.;.;.;.
.;.;.;.;.;.;.;.;.;.;.;.
.;.;.;.;.;.;.;.;.;.;.;.
.;.;.;.;.;.;.;.;.;.;.;.
.;.;.;.;.;.;.;.;.;.;.;.
.;.;.;.;.;.;.;.;.;.;.;.
.;.;.;.;.;.;.;.;.;.;.;.
.;.;.;.;.;.;.;.;.;.;.;.