.;.;.;.;.;1d;.;.;1l;.;.;.
.;.;.;1;.;.;.;.;1;.;.;.
.;.;.;.;.;2;.;.;.;.;.;.
.;.;.;.;.;.;1;1;.;.;.;.
.;.;.;1l;1;.;.;.;.;.;.;.
.;.;.;.;.;.;.;.;.;.;.;.
.;.;.;.;1d;1l;.;.;.;.;.;.
.;.;.;.;.;.;.;1;1;.;.;.
.;.;.;.;.;1d;1l;.;.;.;.;.
.;.;.;.;1;1;1;.;.;.;.;.
.;.;.;.;1;1;.;1;.;.;.;.
.;.;.;.;.;1;1;2;.;.;.;.
