.;.;.;.;1;.;1d;1d;.;.;.;.
.;.;.;.;.;.;2;2;.;.;.;.
.;.;.;1d;.;1;1l;.;.;.;.;.
.;.;.;.;.;.;.;.;.;.;.;.
.;.;.;.;1l;2d;1;.;.;.;.;.
.;.;.;.;.;.;.;.;.;.;.;.
.;.;.;.;.;.;3;1;.;.;.;.
.;.;.;.;.;2d;2l;.;.;.;.;.
.;.;.;.;.;.;1;1;1;.;.;.
.;.;.;.;.;.;2;2;.;.;.;.
.;.;.;.;.;1;1;1;.;.;.;.
.;.;.;.;.;.;3;.;.;.;.;.
